F 30,15,20
C 10,30,50

NO ./textures/TECH_1C.xpm
SO ./textures/TECH_3B.xpm
WE ./textures/TECH_2F.xpm
EA ./textures/TILE_2C.xpm

        1111111111111111111111111
        1000000000110000000000001
        1011000001110000000010001
        1001000000000000000000001
111111111011000001110000000000001
100000000011000001110111111111111
11110111111111011100000010001
11110111111111011101010010001
11000000110101011100000010001
10000000000000001100000010001
100000000000000011010100001N1
11000001110101011111011110111
11110111 1110101 101111010001
11111111 1111111 111111111111
