F 30,15,20
C 10,30,50

NO ./textures/TECH_1C.xpm
SO ./textures/TECH_1C.xpm
WE ./textures/TILE_2C.xpm
EA ./textures/TILE_2C.xpm
DO ./textures/DOOR_1E.xpm

        1111111111111111111111111
        1000000000110000000000001
        1011000001110000000010001
        1001000000000000000000001
111111110011000001110000000000001
10E00D000000000001110111110111111
11100111111111011100000010001
11100111111111010101010010001
110000001101010101000000100D1
10000000000000000D00000010001
10000000000000001101010000101
11000001110101011111011110111
11110111 1110101 101111010001
11111111 1111111 111111111111
