F 30,15,20
C 10,30,50

NO ./textures/TECH_1C.xpm
SO ./textures/TECH_3B.xpm
WE ./textures/TECH_3B.xpm
EA ./textures/TECH_3B.xpm
DO ./textures/DOOR_1A.xpm

11111111111111
    1000000001
    1000000001
1111DDDDD11111
100000DDD1
1000N00001
101DD10001
100D100001
1000000001
1111111111

